################################
#            # ##      #     # #
#  /   # #####         # ##### #
#      #       ##      #       #
########### ############### ####
#   #               #          #
#     #        ##     #        #
#   #          ##   #          # 
#     #        ##     #        #
########################### ####
########################### ####
########### ############### ####
#   #               #          #
#     #        ##     #        #
#   #          ##   #          #
#     #        ##     #        #
################################
################################